NO textures/text3.png
SO textures/text3.1.png
WE textures/text3.2.png
EA textures/text3.3.png
F 234,161,192
C 168, 176, 189

        1111111111111111111111111
111111111000000000000000000000001
100000000000000011010100100011111
1100000111010101110101111000111
11110101 1010101 101011010011
11110111 1111111 11111111101
   101                   101
   101                   101
   101                   101
   101                   101
   1011111111111111111111101
   1000000000000000000000001
   1111111111110111111111111
   1111111111110111111111111
1111111111111110111111111111111111111111
   1000000000000000000000001
   1000000000000001000000001
   1000000000000000000000001
111110000000001111111111111111111111111111111111
110000000000000000000000000000000000000000000001
110000000000000000000000000000000000000000000001
110001111111110000000100100100000000000000000001
110000000000000000100000000000100000000000000001
110000000000000000000000000000000000000000000001
110000000000000010000000000000001000000000000001
110000000000000000000000000000000000000000000001
110000000000000000100000000000001000000000000001
110000000000000000000000000000100000000000000001
110000000000000000000100100100000000000000000001
110000000000000000000000000000000000000000000001
110000000000000000000000000000000000000000000001
110000000000000000000000000000000000000000000001
110000000000000000000000000000000000000000000001
110000000000000000000000000000000000000000000001
110000000000000000001010000000000000000000000001
110000000000000000001N10000000000000000000000001
110000000000000000001110000000000000000000000001
110000000000000000000000000000000000000000000001
110000000000000000000000000000000000000000000001
110000000000000000000000000000000000000000000001
111111111111111111111111111111111111111111111111