NO textures/Bricks/Brick 10 - 256x256.png
SO textures/Bricks/Brick 14.2 - 256x256.png
WE textures/Bricks/Brick 16 - 256x256.png
EA textures/Bricks/Brick 14 - 256x256.png
F 175, 143, 133
C 153, 204, 255
       


   11111
  11011111
  110111N111111111111
  1011 111
  1111             

      
