NO textures/Bricks/Brick 10 - 256x256.png
SO textures/Bricks/Brick 14.2 - 256x256.png
WE textures/Bricks/Brick 16 - 256x256.png
EA textures/Bricks/Brick 14 - 256x256.png
F 175, 143, 133
C 153, 204, 255

 111111111111111
1100000000010001
 10E000000010001
 100000000000001
 111111110001111
        11111
