NO textures/text5.png
SO textures/text2.png
WE textures/text3.png
EA textures/text4.png
F 68, 102, 0
C 153, 204, 255



            1111
            1001
    1111111111111111111111111
    1000000000110000000000001
    1011000001110000000000001
    1001000000000000000000001
11111111101100000111000000001
100000000011000001110111101111111
11110111111111011100000010001
11110111111111011101010010001
11000000110101011100000010001
10000000000000001100000010001
10000000000000001101010010001
11000001110101011111011110N0111
11110111 1110101 101111010001
11111111 1111111 111111111111
