NO textures/Bricks/Brick 10 - 256x256.png
SO textures/Bricks/Brick 14.2 - 256x256.png
WE textures/Bricks/Brick 16 - 256x256.png
EA textures/Bricks/Brick 14 - 256x256.png
F 175, 143, 133
C 153, 204, 255

        1111111111111111111111111
111111111000000000000000000000001
100000000000000011010100100011111
1100000111010101110101111000111
11110101 1010101 101011010011
11110111 1111111 11111111101
   101                   101
   101                   101
   101                   101
   101                   101
   1011111111111111111111101
   1000000000000000000000001
   1111111111110111111111111
   1111111111110111111111111
1111111111111110111111111111111111111111
   1000000000000000000000001
   1000000000000001000000001
   1000000000000000000000001
111110000000001111111111111111111111111111111111
110000000000000000000000000000000000000000000001
110000000000000000000000000000000000000000000001
110000000000000000000000000000000000000000000001
110000000000000000000000000000000000000000000001
110000000000000000000000000000000000000000000001
110000000000000000000000000000000000000000000001
110000000000000000000000000000000000000000000001
110000000000110001100011111111000000000000000001
110000000000110001100000000011000000000000000001
110000000000110001100000000011000000000000000001
110000000000111111100011111111000000000000000001
110000000000000001100011000000000000000000000001
110000000000000001100011000000000000000000000001
110000000000000001100011000000000000000000000001
110000000000001111110011111110000000000000000001
110000000000000000000000000000000000000000000001
110000000000000000000000000000000000000000000001
110000000000000000000000000000000000000000000001
110000000000000000000000000000000000000000000001
110000000000000000000000000000000000000000000001
110000000000000000001010000000000000000000000001
110000000000000000001N10000000000000000000000001
110000000000000000001110000000000000000000000001
110000000000000000000000000000000000000000000001
110000000000000000000000000000000000000000000001
110000000000000000000000000000000000000000000001
111111111111111111111111111111111111111111111111